8 12
NNNNNNNNNNNN
NNNNNNNNNNNN
WWWWWWWWWWWW
WNNNNGGGNBNW
WNBBBAAANBPW
WNNNNGGGNBNW
WWWWWWWWWWWW
NNNNNNNNNNNN